6 6
0 0 0 0 0 0 0
0 0 0 0 0 0 0
0 0 0 0 0 0 0
0 0 0 0 0 0 0
0 0 0 0 0 0 0
0 0 0 0 0 0 0
0 0 0 0 0 0 0
3 5 3 4 5 2 3
1 6 3 5 3 1 4
3 4 6 1 6 2 6
-1 1 2 5 2 3 1