5 7
0 0 0 0 0 0
0 0 0 0 0 0
0 0 0 0 0 0
0 0 0 0 0 0
0 0 0 0 0 0
0 0 0 0 0 0
0 0 0 0 0 0
2 5 3 4 5 2
1 2 3 5 3 1
3 4 5 1 2 1
-1 4 2 5 3 3