4 8
0 0 0 0 0
0 0 0 0 0
0 0 0 0 0
0 0 0 0 0
0 0 0 0 0
0 0 0 0 0
0 0 0 0 0
1 2 3 2 3
2 2 4 3 4
1 1 4 2 4
-1 3 2 1 2